C 225,30,0

NO ./TEXTURES/NO.xpm

SO ./TEXTURES/SO.xpm

WE ./TEXTURES/WE.xpm 

EA ./TEXTURES/EA.xpm 

F 220,100,0


1111111111111111111111
1011110000101101110101
110000000000N000000001
1011111000110000000101
11   10010000000000001
1011111000110000000101
1111000001010000000011
1101000000000010000001
1111111111111111111111
