C 225,30,0
NO TEXTURES/reb_missr.xpm

SO TEXTURES/SO.xpm


WE TEXTURES/WE.xpm
  EA TEXTURES/EA.xpm

F 220,100,0





111111111111111111111111111111111111111
101111000010110111010000000000000000001
110000000000000000000000000000000000001
101111100011000000010000000000000000001
110    10010000000000000000000000000001
1011111000110000N0010000000000000000001
111100000101000000001000000000000000001
  1010000000000100000000000000000000001
110000000000000000000000000000001111111
100000000000000000000000000000001111111
111111111111111111111111111111111111111
