C 225,30,0
NO Global_main.c

SO Global_main.c

WE Global_main.c
  EA Global_main.c

F 220,100,0





1111111111111111111111111111111111111111111111111111111111111111111111111111111111111111111111111111111111111111111111111111111111111111                   
10111100001011011101000000000000000000000000000000000000000000000000001100000000000000000000000000000000000000000000000000000001
1100000000000000000000000000000000000000000000000000000000011000000000011000000000000000000000000000000000000000000000000000111111      1 
1011111000110000000100000000000000000000000111001111001111110000011000001100000000000000000000000000000000000000000000000000000001111
110    100100000000000000000000000000000000111001111001111110000000110000110000000000000000000000000000000000000000000000000001111       1        
1011111000110000N00100000000000000000000000000000000000001100000011000001100000000000000000000000000000000000000000000000000011
1111000001110000000010000000000000000000000000000000000000110110000000011000000000000000000000000000000000000000000000000000011
  10100000000001000000000000000000000000000000000000000000011000000000110000000000000000000000000000000000000000000000000000001
110000000000000000000000000000001111111111111111111111111111111111111111111111111111111111111111111111111111111111111111111111111111111111
100000000000000000000000000000001111111111111111111111111111111111111111111111111111111111111111111111111111111111111111111111111111111111
100000000000000000000000000000001
100000000000000000000000000000001
100000000000000000000000000000001
10000000000000000000000000000000111111111111111111111
10000000000000000000000000000000000000000000000000001
10000000000000000000000000000000000000001110000000001
10000000000000000000000000000000000000001110000000001
10000000000000000000000000000000111111111111111111111
100000000000000000000000000000001
100000000000000000000000000000001
100000000000000000000000000000001
10000000000000000000000000000000111111111111111111111111111111111111111111111111111111111111111111111111111111111111111111111111111111111111
10000000000000000000000000000000000000000000000000000000000000000000000000000000000000000000000000000000000000000000000000000000000000000001
10000000000000000000000000000000000000000000000000000000000000000000000000000000000000000000000000000000000000000000000000000000000000000001
10000000000000000000000000000000000000000000000000000000000000000000000000000000000000000000000000000000000000000000000000000000000000000001
10000000000000000000000000000000000000000000000000000000000000000000000000000000000000000000000000000000000000000000000000000000000000000001
10000000000000000000000000000000000000000000000000000000000000000000000000000000000000000000000000000000000000000000000000000000000000000001
10000000000000000000000000000000000000000000000000000000000000000000000000000000000000000000000000000000000000000000000000000000000000000001
10000000000000000000000000000000000000000000000000000000000000000000000000000000000000000000000000000000000000000000000000000000000000000001
10000000000000000000000000000000000000000000000000000000000000000000000000000000000000000000000000000000000000000000000000000000000000000001
10000000000000000000000000000000000000000000000000000000000000000000000000000000000000000000000000000000000000000000000000000000000000000001
11111100011111111111100011111111111110000111111111100011111111111111111111111111111111111111111111111110000000000000000000000000000000000011
11111100011111111111100011111111111110000100111111100011111111111111111111111111000000001111111111111111000000000000000000000000000000000001
11111100011111111111100011111111111110000000111111100011111111111111111111111111010110001111111111111111000000000000000000000000000000000001
11111100011111111111100000000000000111111111111000000000000000000011111111111110000000001111111111111111000000000000000000000000000000000001
11111100011111111111111000000000000111111111111000000000000000000000000000000000000000000000000000000000000000000000000000000000000000000001
11111100000001111111111111111000000111111111111111111111111110000011111111111111111111111111111111111111000000000000000000000000000000000001
11111100000001111111110000000000000111111111111111111111111110000011111111111111111111111111111111111111000000000000000000000000000000000001
11111100011111111111111000000000000111111111100000000000000000011111111111111111111111111111111111100000000000000000000000000000000000111111
11000000011111111111111111111000000111111111100000000000000001111111111111111111111111111111111111100000000000000000000000000000000000111111
11000000011111111111111111111000000111111111100111111111111110000011111111111111111111111111111111111111000000000000000000000000000000000001
11111100011111111111111000000000000111111111100111111111111110000000000000000000000000000000000000000000000000000000000000000000000000000001
11111100011111111111111000000000000111111111100111111111111110000011111111111110000111111111111111111111000000000000000000000000000000000001
11111100010000001111000000001111100000001111100111111111111111111111111111111110000111111111111111111111000000000000000000000000000000000001
11111100000111100000011111100000001111100000000111111111111111111111111111111110110111111111111111111111000000000000000000000000000000000001
11111111111111111111111111111111111111111111111111111111111111111111111111111111111111111111111111111111111111111111111111111111111111111111
