C 121,178,226

NO TEXTURES/egyguarder.xpm 
         
SO TEXTURES/brikbolla.xpm
WE TEXTURES/neutre.xpm
  EA TEXTURES/Ktabat.xpm

F 32,178,170

     11111111111111111111111111111111
     100000000000000000000000010001001
     10E000000000000000000000000000001                                          
     111111110000000000000011111111111                            11111111111111
            1000000000000001                                      10000000000001
            1000000000000001                                      10000011111001
            1000000000000001                                      1000001   1001
            100000000000000111111111111111111                     1000001   1111
            10000000000000000000000000000000111111111111111111    1000001
            10000000000000000000000000000000000000000000000001111110000011111
            10000000000000000000000000000000000000000000000000000000000000001
            10000000000000000000000000000000000000000000000000000000000000001
            10000000000000000000000000000000111111111111111111000000000000001
            111110011111100000000111110011111                 100000000000001
              10000000000000000000000111                      100000000000001
              1111111111111111111111111                       100000000000001
                                                              111100000011111
                                                                  1000001
                                                                  1000001
                                                                  1000001
                                                                  1000001
                                                                  1111111