C 225,30,10

NO ./TEXTURES/EA.xpm

SO ./TEXTURES/SO.xpm

WE ./TEXTURES/WE.xpm 

EA ./TEXTURES/NO.xpm

F 20,40,60

1111111111111111
1000100000S00001
1000000011110001
10000011111000101
1111100111111111
1000000000000011
1111111111111111