NO Global_main.c
SO Global_main.c
WE Global_main.c
EA Global_main.c
F 220,100,0
C 225,30,0





11111111111 11111111111111
10111100001111011101000011
1100000000000000000000111
10111110001100000001000011
11     0001E000000000000011
10111110001100000001000011
1011000001110000000010011
110100000000001000000001
111111111111101111111111
111111111111111111111111