NO Global_main.c
SO Global_main.c
WE Global_main.c
EA Global_main.c
F 220,100,0
C 225,30,0





11111111111111111111111111                   
10111100001011011101000001
11000000000N0000000000111111           1  
1011111000110000000100000000111
11     000100000000000000111           1
10111110001100000001000011
111100000111000000001001
  10100000000001000000001
111111111111101111111111
111111111111111111111111 