NO Global_main.c
SO Global_main.c
WE Global_main.c
EA Global_main.c
F 220,100,0
C 225,30,0





1111111111111111111111111111111111
11111111111000000000000000000000011
111101100000010000111000000000111111111
111110000000100001110111111111111
11111111100110110111000000000111
111111110000110000010100100011111111
111110001101010000000000100000000011
111111100000000000000001000111111111
11111010000000010010100100010000011
     100000000011010100100010000011111
     100000000011010100100010000011111
111110011101010111110111100111101111
111111111111111111111N11111100000011
111111111111111111111111111111111111