NO Global_main.c
SO Global_main.c
WE Global_main.c
EA Global_main.c
F 220,100,0
C 225,30,0





11111111111 11111111111111                   
1011110000111101110100001
110000000000000000000011
10111110001100000001000011
11     0001W000000000000011
10111110001100000001000011
101100000111000000001001
 10100000000001000000001
111111111111101111111111
111111111111111111111111 