C 121,178,226

NO TEXTURES/NO.xpm           
SO TEXTURES/SO.xpm
WE TEXTURES/WE.xpm
  EA TEXTURES/EA.xpm

F 5,0,2

     111111111111111111111111111111111
     100000000000000000000000010001001
     10E000000000000000000000000000001
     111111110000000000000011111111111
     111111111111111111111111111111111